111111111111111111000A11
100010000011000000010111
101010111000101011110111
111000110111001110000001
100000000100000000111011
111101111100110110001111
000000011100010000100011
110101001001010111011101
100101111101011100000101
001000000101000001111001
11001011110E011110000011
111110000001100000111101
011000011110001110000001
000111000000111011110111
110001010110000000011001
110101010000111111000001
001100011111000011010101
100000001100011110010100
101110100000110001111001
101000111100000100000011
101010001001010111101011
101010101111010011001111
1G1010100010011000100011
111011111011001011101111
